|--------|
|.E.|..-.|
|..-|.@..|
|.E....-.|
|--------|