|--------|
|.E.|..-.|
|..-|.@.B|
|.E....-.|
|--------|